@..........##W.
.#####.###..##.
.#.......##..#.
.#.######*#..#.
.#..#....#..#..
..#..###..#...#
#..##...#..#.#.
##..#.#.##.#.#.
###.#.#....#...
......##.#.#.##
.##**#.#..#..#.
...#*#..#..#.#.
###...#.####.#.
#...#..........