@.a.....#a.....
#.#####.#.##.*.
a.*a..#...#..#.
#.***.#**.#.*a.
*.....#a..#..#.
a#.#a#..*..#a#.
.#..#*#..*..#..
.#*..#a#a#.*a..
.......**a.##*.
.*##*##..#..#..
.#a.#.....#.#.*
.a#.#.#.*...#..
..#.#a#.#a###*.
#...a##.a#W....