@..........##W.
.#####.###..##.
.#......a##..#.
.#.######*#..#.
.#..#a...#..#..
..#.a###..#...#
#..##...#..#.#a
##..#.#.##.#.#.
###.#.#....#...
......##.#.#.##
.##*##a#..#..#a
..a#*#..#.a#.*.
###..a#.####.*.
#a..*..........