@.#....#a#.a*a.
.*.*.*...*.*#*.
.#.#a#a#*a.#a#.
.*.*#*###*.....
.#..a#.a##.#.#.
...*#a.*#a.*a#.
.*.#a*.#*#*a*W.
.#.*.#.#a....#.
.*.#.*.*#.*#.*.
.#......*.#*...
.*#*#.*.#..a#a#
....#a#.a.#.*#*
*a*.*#*#*#*..*a
#*a.#a.........